...............................
...............................
...............................
...............................
...............................
...............................
...............................
...............................
...............................
...............................
...I...........................
...I...........................
...I...........................
...I...........................
...I...........................
...I...........................
...I...........................
...I........#######............
...I...........................
...I....................####...
...I...........................
...I............@..............
...I___________________________

{
  "id": "tutorial"
}
